----------------
----------------
----------------
----------------
----------------
----------------
----------------
----------------
----------------
----------------
----------------
----------------
----------------
---M--------F---
XXXXXXXXXXXXXXXX
XXXXXXXXXXXXXXXX